B P 1 1
B NY 1 1
P B 1 1
P NY 1 1
NY C 1 1
C D 1 1
C Ph 1 1
D Ph 1 1
D NY 1 1